####################
#E    #  ##   # # ##
## #  # # #    # ###
#    #     #   #####
#      # ##     #  #
### #    ###  # #  #
#   #  ### #       #
#     ##        #  #
#  #  #    ###     #
# #    # # # ##    #
#   #     ##    #  #
#   #    #         #
#  ##  #   ## #   ##
#   ## #  # # #   ##
# #   # #          #
# #  #      #  #   #
#    #       # #   #
##  ##  ## ## #   ##
## ##     #        #
#  ###   # #      ##
#    #  #   ##   # #
####      # #      #
#  # #  #  ## ## ###
####   # #  #    #S#
####################