#################
#E  #   ## # #  #
## ###    #     #
#  #            #
#      ##       #
##  ##  #   ##  #
##     ##  #    #
##    #    ## # #
###  ##   #    S#
#################
